Cantonment = Расквартирование;
Cemetery = Кладбище;
Creep = Ползать;
Rather = Довольно;
Fur = Мех;
Quite = Довольно;
Weasel = Ласка;
Habit = Привычка;
Scuttle = стремительное бегство;
Ditch = Канава;
Clung = Державшаяся;
Daggle = Измазывать;
Choke = Задыхаться;
Wrap = Упаковка;
Cotton = Хлопок ;
Wool = Шерсть;
Sneeze = Чихать;
Curiosity = Любопытство;
Harbour = Гавань;
Collar = Воротник;
Rubbing = Трение;
Tame = Укрощать;
Immensely = Чрезвычайно;
Dry = Сухой;
Roots = Корнеплоды;
Certainly = Конечно;
Ink = Чернила;
Lap = Круг;
Nursery = Питомник;
Indeed = Действительно;
Consolation = Утешение;
Plaster = Штукатурка;
Early = Ранний;
Boil = Кипеть;
Splendid = Великолепный;
Snuff = нюхать;
Fiber = Волокно;
Thick = Толстый;
Dandelion = Одуванчик;
Wicked = Злой;
Crept up = Ползти вверх;
Savage = Дикарь;
Trotted = Идти рысью;
Wriggled = Извивавшейся;
Peculiar = Своеобразный;
Inherited = Унаследованный;
Hold = Проводить;
Sideways = В сторону;
Lash = Плеть;
Sprung = Подпружиненный;
Away = Прочь;
Rather = Довольно ;
Amused = Удивленный;
Fuss = Суета;
Creeping = Ползучий;
Whimpers = Хнычет;
Cheep = Пищать;
Scornfully = Презрительно;
Tears = Разрыдаться;
Anything = Что угодно;
Faintest = Легчайший;
Wasp = Оса;
Melon = Дыня;
Thickness = Толщина;
Savage = Дикарь;
Bulge = Выпуклость;
Purchase = Покупка;
Aching = Ноющий;
Tenderly = Нежно;
Stiff = Жесткий;
Rubbish = Чушь;
Sweeper = Уборщик;
Valiant = Доблестный;
Stable = Стабильный;
Mourning = Плач;
Bother = Беспокоить;
Grain = Зерно;
Pretend = Притворяться;
Fluttered = Трепетавший;
Cunningly = Ловко;
Hidden = Крыться;
Curled up = Свернуться калачиком;
Scuttled = Удравшей;
Still = Еще;
Rustle = Шелестеть;
Savagely = Жестоко;
Copper = Медь;
